6
1, 1, 1, 1, 0, 1, 1, 1, 0, 1, 0
0, 0, 1, 1, 1, 1, 0, 0, 0, 1, 0
0, 0, 0, 1, 0, 1, 1, 1, 1, 1, 1
1, 1, 1, 2, 1, 1, 0, 1, 0, 1, 0
0, 0, 0, 1, 0, 0, 0, 0, 0, 1, 0
0, 0, 0, 1, 1, 1, 1, 1, 1, 0, 1
2
10
-
3
1, 1, 1, 1, 0, 1
0, 0, 2, 1, 0, 1
0, 0, 0, 1, 0, 1
0
5
-
6
1, 1, 1, 1, 0, 1, 1, 1
0, 0, 1, 1, 1, 1, 0, 1, 1, 0
0, 0, 0, 1, 0, 1, 1, 1
1, 1, 1, 2, 1, 1, 0, 1, 1, 0
0, 0, 0, 1, 0, 0, 0, 0
0, 0, 0, 1, 1, 1, 1, 1
1
9
-
